Latin,Bengali,Devanagari,Document,Scene,Overall_Image
2633,1654,1043,3095,2235,5330
213,229,248,367,323,690
128,176,95,151,248,399
134,75,49,62,196,258
167,51,27,26,219,245
140,31,8,13,166,179
85,18,4,7,100,107
88,8,3,3,96,99
35,6,2,3,40,43
33,5,1,2,37,39
23,0,0,0,23,23
14,2,0,0,16,16
12,0,0,0,12,12
4,1,0,0,5,5
7,0,0,0,7,7
1,0,0,0,1,1
0,0,0,0,0,0
0,0,0,0,0,0
0,0,0,0,0,0
0,0,0,0,0,0
1,0,0,0,1,1
0,0,0,0,0,0
